#domain
hospital
#levelname
MAD
#colors
red: 0, 1, A
#initial
+++++++++++++++++++
+0A               +
+AA            ++++
+                 +
+     1        ++A+
+               + +
+++++++++++++++++++
#goal
+++++++++++++++++++
+                A+
+              ++++
+                 +
+              ++ +
+               +A+
+++++++++++++++++++
#end