#domain
hospital
#levelname
MAD3
#colors
red: 0, 1, 2, 3, A
#initial
+++++++++++++++++++
+0A      2        +
+AA      3     ++++
+                 +
+   ++1        ++A+
+    +          + +
+++++++++++++++++++
#goal
+++++++++++++++++++
+                A+
+              ++++
+                 +
+   ++         ++ +
+   A+          +A+
+++++++++++++++++++
#end