#domain
hospital
#levelname
MAD4
#colors
red: 0, 1, A
#initial
+++++++++++++++++++
+0A               +
+AA            ++++
+                 +
+   ++1        ++A+
+    +          + +
+++++++++++++++++++
#goal
+++++++++++++++++++
+                A+
+              ++++
+                 +
+   ++         ++ +
+   A+    A     +A+
+++++++++++++++++++
#end