#domain
hospital
#levelname
MAD6
#colors
red: 0, 1, 2, A
#initial
++++++++++++++++
+2             +
+A             +
++++1       ++++
++++A       ++++
+++++++0 +++++++
+++++++A +++++++
++++++++++++++++
#goal
++++++++++++++++
+              +
+             A+
++++        ++++
++++       A++++
+++++++  +++++++
+++++++ A+++++++
++++++++++++++++
#end