#domain
hospital
#levelname
SAchoice
#colors
red: 0, A
#initial
+++++++++++++
+         A +
+0          +
+           +
+           +
+           +
+A          +
+++++++++++++
#goal
+++++++++++++
+           +
+          A+
+           +
+           +
+           +
+           +
+++++++++++++
#end
          
