#domain
hospital
#levelname
SApacman
#colors
red: 0, A, D, E, R, Y
#initial
+++++++++++++++++++++++++++
+            +            +
+ ++++ +++++ + +++++ ++++ +
+ +  + +   + + +   + +  + +
+ ++++ +++++ + +++++ ++++ +
+                         +
+ ++++ ++ +++++++ ++ ++++ +
+ ++++ ++ +++++++ ++ ++++ +
+      ++    +    ++      +
++++++ +++++ + +++++ ++++++
     + +++++ + +++++ +
     + ++         ++ +
     + ++ +++ +++ ++ +
++++++ ++ +     + ++ ++++++
+         +     +         +
++++++ ++ +  0  + ++ ++++++
     + ++ +++++++ ++ +
     + ++  READY  ++ +
     + ++         ++ +
++++++ ++ +++++++ ++ ++++++
+            +            +
+ ++++ +++++ + +++++ ++++ +
+ ++++ +++++ + +++++ ++++ +
+   ++               ++   +
+++ ++ ++ +++++++ ++ ++ +++
+++ ++ ++ +++++++ ++ ++ +++
+      ++    +    ++      +
+ ++++++++++ + ++++++++++ +
+ ++++++++++ + ++++++++++ +
+                         +
+++++++++++++++++++++++++++
#goal
+++++++++++++++++++++++++++
+            +        Y   +
+ ++++ +++++ + +++++ ++++ +
+ +  + +   + + +   + +  + +
+ ++++ +++++ + +++++ ++++ +
+  E                      +
+ ++++ ++ +++++++ ++ ++++ +
+ ++++ ++ +++++++ ++ ++++ +
+      ++    +    ++      +
++++++ +++++ + +++++ ++++++
     + +++++ + +++++ +
     + ++         ++D+
     + ++ +++ +++ ++ +
++++++ ++ +     + ++ ++++++
+   A     +     +         +
++++++ ++ +     + ++ ++++++
     + ++ +++++++ ++ +
     + ++         ++ +
     + ++         ++ +
++++++ ++ +++++++ ++ ++++++
+            +            +
+ ++++ +++++ + +++++ ++++ +
+ ++++ +++++ + +++++ ++++ +
+   ++               ++   +
+++ ++ ++ +++++++ ++ ++ +++
+++ ++ ++ +++++++ ++ ++ +++
+      ++    +    ++      +
+ ++++++++++ + ++++++++++ +
+ ++++++++++ + ++++++++++ +
+    R                    +
+++++++++++++++++++++++++++
#end
