#domain
hospital
#levelname
SAtest
#colors
red: 0, A
#initial
++++++++++++++++++++++++
+                      +
+0A                    +
+                      +
+                      +
+        +++           +
+       ++ AA+++++++++++
++++++++++++++
#goal
++++++++++++++++++++++++
+                      +
+  A                   +
+                      +
+                      +
+        +++           +
+       ++A  +++++++++++
++++++++++++++
#end
