#domain
hospital
#levelname
SATheRedDot
#colors
red: 0, A, B, C, D
#initial
+++++++++++++
+   A 0 B   +
+ +++++++++ +
+ +       + +
+ ++++ ++++ +
+ ++++ ++++ +
+    C D    +
+++ +++++ +++
  +++   +++
#goal
+++++++++++++
+           +
+ +++++++++ +
+ +CB   AD+ +
+ ++++ ++++ +
+ ++++ ++++ +
+           +
+++ +++++ +++
  +++   +++
#end
